1111111111111111
1237000001000301
1010111131610101
1210150003010101
1010101111010101
1210100000010101
1010111111110101
1010000000000101
1011111110111101
1000000000000001
1111111111111111