1111111111111111
1230300001000301
1010111101010101
1210150003010101
1010131111010101
1210000000010101
1010111111110101
1014100000000101
1011111110111101
1000000000000001
1111111111111111